"filename", "language", "Python", "Markdown", "Java Properties", "Java", "XML", "comment", "blank", "total"
"/Users/tobybenjaminclark/Documents/Personal/Hole/hole/README.md", "Markdown", 0, 21, 0, 0, 0, 0, 18, 39
"/Users/tobybenjaminclark/Documents/Personal/Hole/hole/src_computer_vision/computer_vision.py", "Python", 204, 0, 0, 0, 0, 33, 95, 332
"/Users/tobybenjaminclark/Documents/Personal/Hole/hole/src_computer_vision/udp_server.py", "Python", 22, 0, 0, 0, 0, 5, 12, 39
"/Users/tobybenjaminclark/Documents/Personal/Hole/hole/src_server/REST_API/server-api-DEPRACATED/pom.xml", "XML", 0, 0, 0, 0, 73, 0, 3, 76
"/Users/tobybenjaminclark/Documents/Personal/Hole/hole/src_server/REST_API/server-api-DEPRACATED/src/main/java/hackathon/shapeshifters/RestApi.java", "Java", 0, 0, 0, 124, 0, 5, 27, 156
"/Users/tobybenjaminclark/Documents/Personal/Hole/hole/src_server/REST_API/server-api-DEPRACATED/src/main/resources/application.properties", "Java Properties", 0, 0, 2, 0, 0, 0, 1, 3
"/Users/tobybenjaminclark/Documents/Personal/Hole/hole/src_server/REST_API/server-api-DEPRACATED/target/classes/application.properties", "Java Properties", 0, 0, 2, 0, 0, 0, 1, 3
"/Users/tobybenjaminclark/Documents/Personal/Hole/hole/src_server/REST_API/server-api-DEPRACATED/target/classes/hackathon/shapeshifters/RestApi.class", "Java", 0, 0, 0, 45, 0, 0, 0, 45
"/Users/tobybenjaminclark/Documents/Personal/Hole/hole/src_server/REST_API/server-api-DEPRACATED/target/maven-archiver/pom.properties", "Java Properties", 0, 0, 3, 0, 0, 2, 1, 6
"/Users/tobybenjaminclark/Documents/Personal/Hole/hole/src_server/REST_API/server-api-flask/app.py", "Python", 53, 0, 0, 0, 0, 0, 14, 67
"/Users/tobybenjaminclark/Documents/Personal/Hole/hole/src_server/REST_API/server-api-flask/gunicorn_config.py", "Python", 6, 0, 0, 0, 0, 1, 10, 17
"/Users/tobybenjaminclark/Documents/Personal/Hole/hole/src_server/REST_API/server-api-flask/waitress_server.py", "Python", 4, 0, 0, 0, 0, 0, 1, 5
"/Users/tobybenjaminclark/Documents/Personal/Hole/hole/src_server/REST_API/server-api-flask/wsgi.py", "Python", 3, 0, 0, 0, 0, 0, 2, 5
"/Users/tobybenjaminclark/Documents/Personal/Hole/hole/src_server/ServerRunner.py", "Python", 3, 0, 0, 0, 0, 2, 3, 8
"/Users/tobybenjaminclark/Documents/Personal/Hole/hole/src_server/TCP_GameHandler/Handler.py", "Python", 132, 0, 0, 0, 0, 14, 35, 181
"/Users/tobybenjaminclark/Documents/Personal/Hole/hole/src_server/TCP_Relay/Relay.py", "Python", 54, 0, 0, 0, 0, 14, 20, 88
"Total", "-", 481, 21, 7, 169, 73, 76, 243, 1070